CommitID, Committer, FilesChanged, LinesChanges, LinesAdded, LinesDeleted
0775a5c9e669bb6a82d89716cc5146b429ab2f63, Pranav-b-7, 1, 18, 13, 5
154567f9eab5d89645ebe8c1c6f59f90b1be984e, Pranav-b-7, 7, 110, 98, 12
1776a0bb44832d4068b301c82c9acdd09aa23300, yugaa22, 1, 31, 25, 6
177c3c1f5431c11a2e58a7c567a94ef12afee11e, Pranav-b-7, 1, 10, 10, 0
234aee6852cfb0a59f496c78a51c63161b8d2480, Pranav-b-7, 2, 102, 102, 0
2701d15a70a3ae5bad38375134ee416dd2f62318, rahul-chekuri, 2, 70, 14, 56
39dfa4780ea4e01977bbab30f8692069712b406c, Pranav-b-7, 3, 55, 36, 19
3e70a38e5acfe2d78dc824478bddf86c8af09b16, Pranav-b-7, 5, 46, 42, 4
3ec7055ec2bada6d24658b541f452d1d7deb469e, arunkumaropsmx, 3, 28, 28, 0
443d2c94f6b5d82ba2e628f807f8eddf8ae9f6af, Pranav-b-7, 1, 35, 35, 0
67087bedb86bb7a529160639f1327b3f5988cf1c, rahul-chekuri, 3, 30, 28, 2
6d78af80a13bfcd34c5a14768e0920de04347ab0, sriharshakancharla, 1, 0, 0, 0
7d2b93e5162f7c37d5fe929be85270c02b5fda25, Pranav-b-7, 6, 196, 195, 1
8232f86c771b3dcad978a96a7e0d6f074a406570, yugaa22, 8, 225, 220, 5
9b1358b2460c9d8e561756414f043ac906bb0bca, Pranav-b-7, 6, 100, 95, 5
b64c2323bf0afb2ae92de8657994b5397de7344a, rahul-chekuri, 1, 93, 75, 18
b7ae57d15662380e75694a68a047f4d782b9a8b1, rahul-chekuri, 3, 29, 27, 2
cfc9349f05e76b9c32454df461068d0bae9c3b31, Pranav-b-7, 1, 7, 0, 7
d70b8deb2c6bd30560894ab4a93d64a4e01efcce, sriharshakancharla, 1, 2, 1, 1
e21657e5b5d05c6c2de5646195deade85f119f41, sriharshakancharla, 1, 4, 2, 2
f753baee0ef8114072a2e161ced52592a7a3a727, Pranav-b-7, 7, 0, 0, 0
f96362fb0621bc176cbed82069b00a08afc611a0, rahul-chekuri, 1, 2, 2, 0
fbde79f4be6c5789f9d040fe971d668c2892dce2, sriharshakancharla, 1, 4, 3, 1
